10,10,10,10,10,11,12,12,12,12
10,35,35,10,10,11,12,12,12,12
10,35,35,10,10,11,12,12,12,12
10,35,35,10,10,11,11,11,11,11
10,10,10,10,10,10,10,10,11,11
10,10,10,10,10,10,35,35,11,11
10,10,10,10,10,10,35,35,11,11
10,10,10,10,10,10,10,10,11,11
10,10,10,10,10,10,10,10,11,11
10,10,10,10,10,10,10,10,11,11